#################################################
#S...#..........#..........................#.F..#
#.....#.#.......#.....#...................#...#.#
#.....#.#.......#......#......#..........#....#.#
#....#..#.......#.#.......#.............######..#
#....#...#......#..#......#....#...........#....#
#..#.....#....#.#.....#.#..#.....#..............#
#......#.#.....#..#......#.......#.....#........#
#.....#......#.....#....#........#.....#........#
#.....#..........................#.....####.....#
#.....#..........................#.........####.#
#################################################