#########
#S......#
#..###..#
#.#.F.#.#
#.#...#.#
#.#...#.#
#.#...#.#
#..#.#..#
#.......#
#########