.#####################.
#...F#......#....#S...#
#....####..#####.####.#
#....#......#....#....#
#.....................#
###...............#####
...###############.....